1111111111
1010000001
1000000001
10e0003801
1000000001
1555055001
1000000001
1p00000001
1111111111