01111111111
1p111111110
10000000001
11111111101
10000000001
10000000001
1e000000001
11111111111

