101111111
1e0000001
100000000
1000p0001
100000001
100000001
100010001
100010001
100000001
111111110
